####################
#******************#
#*****#******#*****#
#****##******##****#
#******************#
#********##********#
#******************#
#******************#
#******************#
######********######
######********######
######********######
######********######
######********######
#******************#
#******************#
#******************#
#******************#
#******************#
#******************#
#******************#
#******************#
#******************#
#******************#
####################